Time, File, Conversion, Render, Resize, Total, Status
3/14/2019 1:20:54 PM, 100SlidePowerPointPres.ppt, 4255, 2, 12, 4269, Ok
3/14/2019 1:20:55 PM, 131814.xls, 772, 2, 7, 781, Ok
3/14/2019 1:20:55 PM, 1excel 2003.xls, 87, 2, 9, 98, Ok
3/14/2019 1:20:56 PM, 1PPT 2003.ppt, 401, 2, 8, 411, Ok
3/14/2019 1:20:56 PM, 1PPTX 2003.pot, 495, 2, 7, 504, Ok
3/14/2019 1:20:56 PM, 1Read only excel 2003.xls, 25, 2, 9, 36, Ok
3/14/2019 1:20:57 PM, 1Read Only Word 2003.doc, 1240, 2, 9, 1251, Ok
3/14/2019 1:20:57 PM, 1Template excel 2003.xlt, 33, 2, 9, 44, Ok
3/14/2019 1:20:58 PM, 1Word 2003 template.dot, 117, 2, 9, 128, Ok
3/14/2019 1:20:58 PM, 1Word 2003.doc, 57, 2, 9, 68, Ok
3/14/2019 1:20:58 PM, 2003PowerPointPres.PPT, 252, 2, 7, 261, Ok
3/14/2019 1:20:58 PM, 2016 32bit file_colors.docx, 170, 2, 9, 181, Ok
3/14/2019 1:20:58 PM, 2016 32bit file_colors_111.odt, 257, 2, 9, 268, Ok
3/14/2019 1:20:59 PM, 2018.05.25.00.03.04(1).xlsx, 209, 2, 9, 220, Ok
3/14/2019 1:20:59 PM, 2018.05.25.00.03.04.xlsx, 75, 2, 9, 86, Ok
3/14/2019 1:20:59 PM, 29 pages.docx, 113, 2, 9, 124, Ok
3/14/2019 1:21:01 PM, 3 - PrepareForMigration.ppsx, 0, 0, 0, 0, Error
3/14/2019 1:21:02 PM, 3_original.xls, 487, 2, 9, 498, Ok
3/14/2019 1:21:02 PM, 479 Pages.doc, 175, 2, 9, 186, Ok
3/14/2019 1:21:02 PM, 4_original.xlsx, 12, 2, 9, 23, Ok
3/14/2019 1:21:02 PM, 5_original_2007template.xltx, 233, 1, 9, 243, Ok
3/14/2019 1:21:02 PM, 719 Pages.doc, 284, 2, 9, 295, Ok
3/14/2019 1:21:02 PM, all keyboard chars.DOC, 61, 2, 10, 73, Ok
3/14/2019 1:21:04 PM, Big document.doc, 1361, 2, 9, 1372, Ok
3/14/2019 1:21:04 PM, Binary2016.xlsx, 46, 2, 9, 57, Ok
3/14/2019 1:21:06 PM, Buddy Requirement.DOC, 2517, 2, 12, 2531, Ok
3/14/2019 1:21:07 PM, Calorie amortization schedule1.xlsx, 447, 2, 9, 458, Ok
3/14/2019 1:21:07 PM, ClaimsAdmin.pptx, 470, 2, 7, 479, Ok
3/14/2019 1:21:08 PM, ClaimsAdmin2016.pptx, 326, 2, 11, 339, Ok
3/14/2019 1:21:08 PM, ColoredFonts.xlsx, 14, 2, 9, 25, Ok
3/14/2019 1:21:08 PM, ColoredFonts.zip, 0, 0, 0, 0, Error
3/14/2019 1:21:08 PM, created by pam - readonly - final.docx, 51, 2, 9, 62, Ok
3/14/2019 1:21:08 PM, DOC 2013.doc, 62, 2, 9, 73, Ok
3/14/2019 1:21:08 PM, DOCM 2013.docm, 123, 2, 9, 134, Ok
3/14/2019 1:21:09 PM, Document less 5mb-2013.dotm, 494, 2, 9, 505, Ok
3/14/2019 1:21:09 PM, Document Preview-2013.xlsx, 140, 2, 9, 151, Ok
3/14/2019 1:21:09 PM, DOCX 2013.docx, 188, 2, 9, 199, Ok
3/14/2019 1:21:09 PM, DOT 2013.dot, 137, 2, 9, 148, Ok
3/14/2019 1:21:09 PM, DOTM 2013.dotm, 226, 2, 7, 235, Ok
3/14/2019 1:21:09 PM, DOTX 2013.dotx, 91, 1, 9, 101, Ok
3/14/2019 1:21:10 PM, EmptyDoc 2003.doc, 6, 10, 9, 25, Ok
3/14/2019 1:21:10 PM, Emptyexcel2003.xls, 0, 0, 0, 0, Error
3/14/2019 1:21:10 PM, emptyexceltemplate2003.xlt, 0, 0, 0, 0, Error
3/14/2019 1:21:10 PM, emptyppt.ppt, 54, 2, 7, 63, Ok
3/14/2019 1:21:12 PM, Entire_Gutenberg_Twain_Texts.rtf, 0, 0, 0, 0, Error
3/14/2019 1:21:12 PM, excel 2003.xls, 23, 3, 9, 35, Ok
3/14/2019 1:21:12 PM, Excel 2007 read only.xlsx, 46, 2, 9, 57, Ok
3/14/2019 1:21:12 PM, Excel 2007 template.xltm, 45, 2, 9, 56, Ok
3/14/2019 1:21:12 PM, Excel 2007 template.xltx, 60, 3, 10, 73, Ok
3/14/2019 1:21:12 PM, Excel 2007.xlsb, 75, 2, 9, 86, Ok
3/14/2019 1:21:12 PM, Excel 2007.xlsm, 46, 2, 9, 57, Ok
3/14/2019 1:21:12 PM, Excel 2007.xlsx, 51, 2, 9, 62, Ok
3/14/2019 1:21:12 PM, excel 2010.xlsb, 26, 2, 9, 37, Ok
3/14/2019 1:21:13 PM, excel 2010.xlsm, 29, 2, 9, 40, Ok
3/14/2019 1:21:13 PM, excel 2010.xlsx, 26, 2, 9, 37, Ok
3/14/2019 1:21:13 PM, excel 2016.xlsx, 25, 2, 10, 37, Ok
3/14/2019 1:21:13 PM, excel 2016_1page.xls, 24, 2, 9, 35, Ok
3/14/2019 1:21:13 PM, excel1 2003.XLS, 26, 2, 9, 37, Ok
3/14/2019 1:21:13 PM, Excel1 2007 template.XLTM, 45, 1, 9, 55, Ok
3/14/2019 1:21:13 PM, Excel1 2007.XLSM, 45, 2, 9, 56, Ok
3/14/2019 1:21:13 PM, excel1 2010.XLSB, 28, 2, 9, 39, Ok
3/14/2019 1:21:13 PM, excel2013_empty.xlsx, 0, 0, 0, 0, Error
3/14/2019 1:21:13 PM, Excel_5worksheets_500rows.xls, 446, 2, 9, 457, Ok
3/14/2019 1:21:14 PM, Excel_5worksheets_500rows.xlsx, 448, 2, 9, 459, Ok
3/14/2019 1:21:14 PM, given_simple_pp_macro_template.POTM, 84, 2, 7, 93, Ok
3/14/2019 1:21:14 PM, given_simple_pp_template.POTX, 101, 17, 14, 132, Ok
3/14/2019 1:21:14 PM, ImageRight MINT POC Issues-2013.xlt, 201, 2, 7, 210, Ok
3/14/2019 1:21:14 PM, ImageRightFaxCover.dot, 146, 2, 9, 157, Ok
3/14/2019 1:21:15 PM, IR Viewer Retail-2013.potx, 245, 2, 7, 254, Ok
3/14/2019 1:21:15 PM, IR Viewer Retail-2013.ppsx, 0, 0, 0, 0, Error
3/14/2019 1:21:16 PM, IR Viewer Retail-2013.pptm, 512, 2, 8, 522, Ok
3/14/2019 1:21:16 PM, IR Viewer Retail-2013.pptx, 193, 2, 7, 202, Ok
3/14/2019 1:21:16 PM, Large.xlsx, 162, 2, 9, 173, Ok
3/14/2019 1:21:23 PM, LargeBook1.xlsx, 6872, 2, 9, 6883, Ok
3/14/2019 1:21:23 PM, Macro 2016.xlsm, 34, 2, 9, 45, Ok
3/14/2019 1:21:24 PM, macro2016.pptm, 469, 2, 7, 478, Ok
3/14/2019 1:21:24 PM, Macroword 2016.docm, 298, 2, 9, 309, Ok
3/14/2019 1:21:24 PM, Mad kitty.docx, 63, 2, 9, 74, Ok
3/14/2019 1:21:24 PM, OCR FAQ - 2013.dotx, 81, 1, 9, 91, Ok
3/14/2019 1:21:24 PM, OCR Workflow Scripting-2013.docm, 55, 3, 11, 69, Ok
3/14/2019 1:21:24 PM, POT 2013.pot, 222, 2, 7, 231, Ok
3/14/2019 1:21:24 PM, POTM 2013.potm, 96, 2, 7, 105, Ok
3/14/2019 1:21:25 PM, POTX 2013.potx, 151, 2, 7, 160, Ok
3/14/2019 1:21:25 PM, powerpoint file in ppSm (show .PPSM, 0, 0, 0, 0, Error
3/14/2019 1:21:26 PM, powerpoint file in ppSm (show macro)format.ppsm, 0, 0, 0, 0, Error
3/14/2019 1:21:27 PM, powerpoint file in ppSx (show )format.ppsx, 0, 0, 0, 0, Error
3/14/2019 1:21:28 PM, powerpoint file in ppSx (show .PPSX, 0, 0, 0, 0, Error
3/14/2019 1:21:28 PM, powerpoint file in pptm (macro)format.pptm, 371, 2, 7, 380, Ok
3/14/2019 1:21:29 PM, powerpoint file in pptm (macro.PPTM, 395, 2, 7, 404, Ok
3/14/2019 1:21:29 PM, powerpoint file in pptx format.pptx, 332, 2, 7, 341, Ok
3/14/2019 1:21:29 PM, PPS.pps, 0, 0, 0, 0, Error
3/14/2019 1:21:30 PM, PPSM 2013.ppsm, 0, 0, 0, 0, Error
3/14/2019 1:21:30 PM, PPSX 2013.ppsx, 0, 0, 0, 0, Error
3/14/2019 1:21:31 PM, PPT 2003 read-only.ppt, 410, 2, 7, 419, Ok
3/14/2019 1:21:31 PM, PPT 2003.ppt, 341, 2, 7, 350, Ok
3/14/2019 1:21:31 PM, PPT 2013.ppt, 370, 2, 7, 379, Ok
3/14/2019 1:21:32 PM, PPT2013_empty.pptx, 88, 2, 7, 97, Ok
3/14/2019 1:21:32 PM, PPTM.pptm, 91, 2, 8, 101, Ok
3/14/2019 1:21:32 PM, PPTX 2003.POT, 390, 2, 7, 399, Ok
3/14/2019 1:21:32 PM, PPTX 2007.pptm, 314, 2, 7, 323, Ok
3/14/2019 1:21:33 PM, PPTX 2007.pptx, 301, 2, 7, 310, Ok
3/14/2019 1:21:33 PM, pptx 2010 - read-only-final.pptx, 420, 2, 7, 429, Ok
3/14/2019 1:21:34 PM, pptx 2010.pptm, 404, 2, 7, 413, Ok
3/14/2019 1:21:34 PM, pptx 2010.pptx, 390, 2, 7, 399, Ok
3/14/2019 1:21:34 PM, PPTX 2013.pptx, 147, 2, 7, 156, Ok
3/14/2019 1:21:34 PM, Print Screen.doc, 69, 2, 10, 81, Ok
3/14/2019 1:21:34 PM, Read only excel 2003.xls, 24, 2, 10, 36, Ok
3/14/2019 1:21:34 PM, read only excel 2010.xlsx, 26, 3, 12, 41, Ok
3/14/2019 1:21:34 PM, read only excel 2016.xlsx, 25, 2, 9, 36, Ok
3/14/2019 1:21:34 PM, Read only excel1 2003.XLS, 29, 2, 10, 41, Ok
3/14/2019 1:21:35 PM, Read Only Word 2003.doc, 52, 2, 9, 63, Ok
3/14/2019 1:21:35 PM, read only word 2010.docx, 136, 1, 9, 146, Ok
3/14/2019 1:21:35 PM, read only word 2016.docx, 163, 2, 9, 174, Ok
3/14/2019 1:21:35 PM, Read-only-2013.xlsx, 55, 2, 9, 66, Ok
3/14/2019 1:21:35 PM, read-only-YN-2013.docm, 101, 2, 9, 112, Ok
3/14/2019 1:21:36 PM, read-only2016.pptx, 402, 2, 7, 411, Ok
3/14/2019 1:21:36 PM, readonly.docx, 43, 3, 9, 55, Ok
3/14/2019 1:21:37 PM, RTF 2013.rtf, 0, 0, 0, 0, Error
3/14/2019 1:21:37 PM, Scenarios-2013.xlsm, 110, 2, 10, 122, Ok
3/14/2019 1:21:38 PM, SimpleExcelWorksheet.xlsx, 303, 2, 9, 314, Ok
3/14/2019 1:21:38 PM, Template excel 2003.xlt, 25, 2, 9, 36, Ok
3/14/2019 1:21:38 PM, Template excel1 2003.XLT, 24, 2, 11, 37, Ok
3/14/2019 1:21:38 PM, Test FIle.xltx, 9, 2, 10, 21, Ok
3/14/2019 1:21:38 PM, TEST-MULTIPAGE.docx, 56, 2, 9, 67, Ok
3/14/2019 1:21:38 PM, TEST.docx, 43, 2, 10, 55, Ok
3/14/2019 1:21:38 PM, test.xlsx, 7, 2, 9, 18, Ok
3/14/2019 1:21:38 PM, Test1.ppt, 337, 2, 7, 346, Ok
3/14/2019 1:21:38 PM, Test1.xls, 20, 2, 8, 30, Ok
3/14/2019 1:21:39 PM, Test1_2013.pptm, 496, 2, 7, 505, Ok
3/14/2019 1:21:39 PM, Test2.PPT, 358, 2, 10, 370, Ok
3/14/2019 1:21:39 PM, Test2.xls, 7, 2, 10, 19, Ok
3/14/2019 1:21:39 PM, Test3Large.XLS, 76, 2, 9, 87, Ok
3/14/2019 1:21:39 PM, This is a docm file.docm, 47, 2, 10, 59, Ok
3/14/2019 1:21:40 PM, This is a great spot for a mission statement-2013.docx, 166, 2, 7, 175, Ok
3/14/2019 1:21:40 PM, Trouble adding Burn Queues.docx, 65, 2, 9, 76, Ok
3/14/2019 1:21:41 PM, twainmaretext02mtent13rtf.rtf, 0, 0, 0, 0, Error
3/14/2019 1:21:41 PM, Waterton Final WS.xls, 149, 2, 9, 160, Ok
3/14/2019 1:21:42 PM, Wedding budget1-2013.xlsb, 115, 2, 9, 126, Ok
3/14/2019 1:21:43 PM, Werbung_1.PPS, 1355, 2, 7, 1364, Ok
3/14/2019 1:21:43 PM, Word 2003 read-only-final.DOC, 57, 2, 10, 69, Ok
3/14/2019 1:21:43 PM, Word 2003 template.DOT, 57, 2, 9, 68, Ok
3/14/2019 1:21:43 PM, Word 2003.doc, 51, 2, 9, 62, Ok
3/14/2019 1:21:43 PM, Word 2003.one page.doc, 52, 1, 10, 63, Ok
3/14/2019 1:21:43 PM, Word 2007 read only.docx, 57, 2, 9, 68, Ok
3/14/2019 1:21:44 PM, Word 2007 template.DOTM, 341, 2, 7, 350, Ok
3/14/2019 1:21:44 PM, Word 2007 template.dotx, 298, 2, 7, 307, Ok
3/14/2019 1:21:44 PM, Word 2007.docx, 52, 1, 9, 62, Ok
3/14/2019 1:21:44 PM, Word 2010 Template.DOTX, 42, 2, 9, 53, Ok
3/14/2019 1:21:44 PM, word 2010.docm, 133, 2, 9, 144, Ok
3/14/2019 1:21:44 PM, word 2010.docx, 137, 2, 9, 148, Ok
3/14/2019 1:21:45 PM, Word_250 pages.docx, 263, 2, 9, 274, Ok
3/14/2019 1:21:45 PM, Word_500 pages.doc, 226, 2, 9, 237, Ok
3/14/2019 1:21:45 PM, Word_500 pages.docx, 421, 2, 9, 432, Ok
3/14/2019 1:21:46 PM, XLS 2013.xls, 223, 2, 9, 234, Ok
3/14/2019 1:21:46 PM, XLSB 2013.xlsb, 122, 2, 9, 133, Ok
3/14/2019 1:21:46 PM, xlsB formated workbook.xlsb, 8, 2, 9, 19, Ok
3/14/2019 1:21:46 PM, XLSM 2013.xlsm, 144, 2, 14, 160, Ok
3/14/2019 1:21:46 PM, xlsM formated workbook.xlsm, 9, 2, 9, 20, Ok
3/14/2019 1:21:46 PM, XLT 2013.xlt, 76, 2, 7, 85, Ok
3/14/2019 1:21:46 PM, XLTM 2013.xltm, 64, 2, 8, 74, Ok
3/14/2019 1:21:46 PM, XLTX 2013.xltx, 132, 2, 7, 141, Ok
3/14/2019 1:21:46 PM, XSLX 2016.xlsx, 111, 2, 9, 122, Ok
